+-+-+-+-+-+-+-+-+-+-+
|S  |   | |       | |
+-+ + + + +-+ +-+ + +
| |   | | |     |   |
+ +-+ + + + +-+ +-+ +
|   | | |   |   | | |
+ +-+ +-+ +-+-+ + +-+
|       | | |       |
+ +-+-+ +-+ +-+ +-+-+
|     |   |       | |
+-+-+-+-+ + +-+-+-+ +
|   |               |
+ +-+ + + + + +-+-+ +
| |   | | | | | | | |
+ +-+-+-+-+ +-+ + + +
|           |     | |
+ +-+-+ +-+ +-+-+ +-+
|     |   |         |
+-+ + +-+-+ + + +-+ +
|   |     | | |   |X|
+-+-+-+-+-+-+-+-+-+-+
 