+-+-+-+-+-+
|S|   |   |
+ + +-+ +-+
|     | | |
+-+ +-+ + +
|   | |   |
+ +-+ + +-+
|   |     |
+ + + + +-+
| |   |  X|
+-+-+-+-+-+
 